-- -- BW -- KB -- -- RB
-- -- KW -- PB PB PB --
-- -- -- -- -- -- -- --
-- -- -- -- -- QW -- --
-- -- -- -- PW -- -- --
-- -- -- -- -- -- -- --
-- -- -- -- -- -- -- --
-- -- -- -- -- -- -- --